0 0
36 36
6
0 0 4 0 4 4 0 4
7 4 9 6 4 10 2 8
8 8 12 8 12 12 8 12
16 16 20 16 20 20 16 20
24 24 28 24 28 28 24 28
32 32 36 32 36 36 32 36
26 19 31 24 30 25 25 20
22 33 25 33 25 35 22 35
15 0 20 5 15 10 10 5
28 7 30 9 22 17 20 15
24 4 26 6 21 11 19 9
